1111111111111111111111111111111111111111111111111111111111111111
1000000000000000000000000000000110000000000000000000000000000001
1000000000000000000000000000000110000000000000000000000000000001
1001111100001111111111111111000110001111111111111111000011111001
1001111100001111111111111111000110001111111111111111000011111001
1000000000000000000000000000000000000000000000000000000000000001
1000000000000000000000000000000000000000000000000000000000000001
1001111100001100000011111111111111111111111100000011000011111001
1000000000001100000000000000000110000000000000000011000000000001
1000000000001100000000000000000110000000000000000011000000000001
1111111100001111111111111100000110000011111111111111000011111111
0000000100001100000000000000000000000000000000000011000010000000
0000000100001100000000000000000000000000000000000011000010000000
0000000100001100000000000000000000000000000000000011000010000000
1111111100000000000000000000000000000000000000000000000011111111
1000000000000000000000000000000000000000000000000000000000000001
1000000000000000000000000000000000000000000000000000000000000001
1000000000000000000000000000000000000000000000000000000000000001
1000000000000000000000000000000000000000000000000000000000000001
1000000000000000000000000000000000000000000000000000000000000001
1000000000000000000000000000000000000000000000000000000000000001
1000001111100000000000000000000000000000000000000000000000000001
1000001111110000000000000000000110000000000000000000000000000001
1111111111111111111111111111111110000000000000000000000000000001
1111111111111111111111111111111110000000000000000000000000000001
1000000000000001100000000000000000000000000000000000000000000001
1000000000000000000000000000000000000000000000000000000000000001
1001111111111000000001111111111110000000000000000000000000000001
1001000110000000000000000000000110000000000000000000000000000001
1001000000000000000000000000000110000000000000000000000000000001
1001000000011110000000000000000110000000000000000000000000000001
1001111001111111111111111111111110000000000000000000000000000001
1000000000000000000000000000000110000000000000000000000000000001
1000000000000000000000000000000110000000000000000000000000000001
1111111111111111111111111111000110000000000000000000000000000001
1000000000000000000000000000000110000000000000000000000000000001
1000001111111110000000000000000110000000000000000000000000000001
1000000000000000000000000000000110000000000000000000000000000001
1000000000000000000000000000000110000000000000000000000000000001
1000001111000000000000000000000110000000000000000000000000000001
1000001000000000000000000000000110000000000000000000000000000001
1000001000000000000000000000000110000000000000000000000000000001
1000001100000000000000000000000110000000000000000000000000000001
1000001110000000000000000000000110000000000000000000000000000001
1000001111000000000000000000000110000000000000000000000000000001
1000001111100000000000000000000110000000000000000000000000000001
1000001111110000000000000000000110000000000000000000000000000001
1111111111111111111111111111111111111111111111111111111111111111
