1111111111111111111111111111111111111111111111111111111111111111
1000000000000000000000000000000110000000000000000000000000000001
1000000000000000000000000000000110000000000000000000000000000001
1000000000000000000000000000000110000000000000000000000000000001
1000000000000000000000000000000110000000000000000000000000000001
1000000000000000000000000000000110000000000000000000000000000001
1000000000000000000000000000000110000000000000000000000000000001
1000000000000000000000000000000110000000000000000000000000000001
1000000000000000000000000000000110000000000000000000000000000001
1000000000000000000000000000000110000000000000000000000000000001
1000000000000000000000000000000000000000000000000000000000000001
1000000000000000000000000000000000000000000000000000000000000001
1000000000000000000000000000000000000000000000000000000000000001
1000000000000000000000000000000110000000000000000000000000000001
1000000000000000000000000000000110000000000000000000000000000001
1000000000000000000000000000000110000000000000000000000000000001
1000000000000000000000000000000110000000000000000000000000000001
1000001000000000000000000000000110000000000000000000000000000001
1000001100000000000000000000000110000000000000000000000000000001
1000001110000000000000000000000110000000000000000000000000000001
1000001111000000000000000000000110000000000000000000000000000001
1000001111100000000000000000000110000000000000000000000000000001
1000001111110000000000000000000110000000000000000000000000000001
1111111111111111111111111111111110000000000000000000000000000001
1111111111111111111111111111111110000000000000000000000000000001
1000000000000001100000000000000110000000000000000000000000000001
1001111001110001100011100111100110000000000000000000000000000001
1000000000000000000000000000000110000000000000000000000000000001
1001111001100111111001100111100110000000000000000000000000000001
1000000001100001100001100000000110000000000000000000000000000001
1000000001111001100111100000000110000000000000000000000000000001
1000000001100000000001100000000110000000000000000000000000000001
1000000000000111111000000000000110000000000000000000000000000001
1000000000000100001000000000000110000000000000000000000000000001
1000000000000111111000000000000110000000000000000000000000000001
1000000000000000000000000000000110000000000000000000000000000001
1000000000000000000000000000000110000000000000000000000000000001
1000000000000000000000000000000110000000000000000000000000000001
1000000000000000000000000000000110000000000000000000000000000001
1000000000000000000000000000000110000000000000000000000000000001
1000000000000000000000000000000110000000000000000000000000000001
1000001000000000000000000000000110000000000000000000000000000001
1000001100000000000000000000000110000000000000000000000000000001
1000001110000000000000000000000110000000000000000000000000000001
1000001111000000000000000000000110000000000000000000000000000001
1000001111100000000000000000000110000000000000000000000000000001
1000001111110000000000000000000110000000000000000000000000000001
1111111111111111111111111111111110000000000000000000000000000001
