11111111111111111111111111111111
10000000000000011000000000000001
10011110011100011000111001111001
10000000000000000000000000000001
10011110011001111110011001111001
10000000011000011000011000000001
10000000011110011001111000000001
10000000011000000000011000000001
10000000000001111110000000000001
10000000000001000010000000000001
10000000000001111110000000000001
10000000000000000000000000000001
10000000000000000000000000000001
10000000000000000000000000000001
10000000000000000000000000000001
10000000000000000000000000000001
10000000000000000000000000000001
10000010000000000000000000000001
10000011000000000000000000000001
10000011100000000000000000000001
10000011110000000000000000000001
10000011111000000000000000000001
10000011111100000000000000000001
11111111111111111111111111111111

